{
  editor.map.Room: {
    path: none
    width: 10
    height: 10
    tiles: {
      textures: [
        {
          path: tiles/pipo.png
          begin: 1
          end: 1992
        }
        {
          path: "tiles/ground/[A]Wall-Up2_pipo.png"
          begin: 1993
          end: 48
        }
        {
          path: "collision.png"
          begin: 2041
          end: 64
        }
      ]
      FLOOR1: [
        2001,1995,1995,1995,1995,1995,1995,1995,1995,2002,
        2005,353,354,354,354,354,354,354,355,2005,
        2005,361,362,362,362,362,362,362,363,2005,
        2005,289,289,289,289,289,289,289,289,2005,
        2005,289,289,289,289,289,289,289,289,2005,
        2005,289,289,289,289,289,289,289,289,2005,
        2005,289,289,289,289,289,289,289,289,2005,
        2005,289,289,289,289,289,289,289,289,2005,
        2005,289,289,289,289,289,289,289,289,2005,
        2009,1995,1995,1995,289,289,1995,1995,1995,2010
      ]
      FLOOR2: []
      DECORATIONS1: []
      DECORATIONS2: []
      COLLISION: [
        2041,2041,2041,2041,2041,2041,2041,2041,2041,2041,
        2041,2041,2041,2041,2041,2041,2041,2041,2041,2041,
        2041,2041,2041,2041,2041,2041,2041,2041,2041,2041,
        2041,0,0,0,0,0,0,0,0,2041,
        2041,0,0,0,0,0,0,0,0,2041,
        2041,0,0,0,0,0,0,0,0,2041,
        2041,0,0,0,0,0,0,0,0,2041,
        2041,0,0,0,0,0,0,0,0,2041,
        2041,0,0,0,0,0,0,0,0,2041,
        2041,2041,2041,2041,0,0,2041,2041,2041,2041
      ]
    }
  }
}