{
  //TODO: implements textures
  content: {
    editor.map.Room: {
      className: editor.map.Room
      path: assets/map/datas/small-room.png
      category: ROOMS
      width: 10
      height: 10
      tiles: {
        FLOOR1: [
          9,3,3,3,3,3,3,3,3,10,
          13,465,466,466,466,466,466,466,466,13,
          13,473,474,474,474,474,474,474,474,13,
          13,374,374,374,374,374,374,374,374,13,
          13,374,374,374,374,374,374,374,374,13,
          13,374,374,374,374,374,374,374,374,13,
          13,374,374,374,374,374,374,374,374,13,
          13,374,374,374,374,374,374,374,374,13,
          13,374,374,374,374,374,374,374,374,13,
          17,3,3,4,374,374,2,3,3,18
        ]
        COLLISION: [
          2041,2041,2041,2041,2041,2041,2041,2041,2041,2041,
          2041,0,0,0,0,0,0,0,0,2041,
          2041,0,0,0,0,0,0,0,0,2041,
          2041,0,0,0,0,0,0,0,0,2041,
          2041,0,0,0,0,0,0,0,0,2041,
          2041,0,0,0,0,0,0,0,0,2041,
          2041,0,0,0,0,0,0,0,0,2041,
          2041,0,0,0,0,0,0,0,0,2041,
          2041,0,0,0,0,0,0,0,0,2041,
          2041,2041,2041,2041,0,0,2041,2041,2041,2041
        ]
      }
    }
    editor.entity.item.Chest: {
      className:  editor.entity.item.Chest
      path: assets/map/datas/coffre.png
      category: DECORS
      width: 1
      height: 1
      tiles: {
        FLOOR1: [910]
        COLLISION: [1993]
      }
    }
  }
}