{
  content: [
    {
      className: game.entity.item.Room
      path: assets/map/datas/rooms/Room1.png
      hover: une salle
      category: ROOMS
      width: 8
      height: 11
      tiles: {
        FLOOR1: [
          9,3,3,3,3,3,3,10,
          13,417,418,418,418,418,419,13,
          13,425,426,426,426,426,427,13,
          13,337,337,337,337,337,337,13,
          13,337,337,337,337,337,337,13,
          13,337,337,337,337,337,337,13,
          13,337,337,337,337,337,337,13,
          13,337,337,337,337,337,337,13,
          21,337,337,337,337,337,337,21,
          417,337,337,337,337,337,337,419,
          425,15,15,337,337,15,15,427,
        ]
        FLOOR2: [
          0,0,0,0,0,0,0,0,
          0,0,0,0,0,0,0,0,
          0,0,0,0,0,0,0,0,
          0,0,0,0,0,0,0,0,
          0,0,0,0,0,0,0,0,
          0,0,0,0,0,0,0,0,
          0,0,0,0,0,0,0,0,
          0,0,0,0,0,0,0,0,
          0,0,0,0,0,0,0,0,
          0,0,0,0,0,0,0,0,
          0,0,0,0,0,0,0,0,
        ]
        DECORATIONS1: [
          0,0,0,0,0,0,0,0,
          0,0,0,0,0,0,0,0,
          0,0,0,0,0,0,0,0,
          0,0,0,0,0,0,0,0,
          0,0,0,0,0,0,0,0,
          0,0,0,0,0,0,0,0,
          0,0,0,0,0,0,0,0,
          0,0,0,0,0,0,0,0,
          0,0,0,0,0,0,0,0,
          0,0,0,0,0,0,0,0,
          0,0,0,0,0,0,0,0,
        ]
        DECORATIONS2: [
          0,0,0,0,0,0,0,0,
          0,0,0,0,0,0,0,0,
          0,0,0,0,0,0,0,0,
          0,0,0,0,0,0,0,0,
          0,0,0,0,0,0,0,0,
          0,0,0,0,0,0,0,0,
          0,0,0,0,0,0,0,0,
          0,0,0,0,0,0,0,0,
          0,0,0,0,0,0,0,0,
          0,0,0,0,0,0,0,0,
          0,0,0,0,0,0,0,0,
        ]
        COLLISION: [
          2041,2041,2041,2041,2041,2041,2041,2041,
          2041,0,0,0,0,0,0,2041,
          2041,0,0,0,0,0,0,2041,
          2041,0,0,0,0,0,0,2041,
          2041,0,0,0,0,0,0,2041,
          2041,0,0,0,0,0,0,2041,
          2041,0,0,0,0,0,0,2041,
          2041,0,0,0,0,0,0,2041,
          2041,0,0,0,0,0,0,2041,
          2041,0,0,0,0,0,0,2041,
          2041,2041,2041,0,0,2041,2041,2041,
        ]
      }
    }

    {
      className: game.entity.item.Room
      path: assets/map/datas/rooms/Room2.png
      hover: une salle
      category: ROOMS
      width: 12
      height: 17
      tiles: {
        FLOOR1: [
          6,3,3,3,3,337,337,3,3,3,3,10,
          13,417,418,418,419,337,337,417,418,418,419,13,
          13,425,426,426,427,337,337,425,426,426,427,13,
          13,337,337,337,337,337,337,337,337,337,337,13,
          13,337,337,337,337,337,337,337,337,337,337,13,
          13,337,337,337,337,337,337,337,337,337,337,13,
          13,337,337,337,337,337,337,337,337,337,337,13,
          13,337,337,337,337,337,337,337,337,337,337,337,
          13,337,337,337,337,337,337,337,337,337,337,337,
          13,337,337,337,337,337,337,337,337,337,337,13,
          13,337,337,337,337,337,337,337,337,337,337,13,
          13,337,337,337,337,337,337,337,337,337,337,13,
          13,337,337,337,337,337,337,337,337,337,337,13,
          13,337,337,337,337,337,337,337,337,337,337,13,
          21,337,337,337,337,337,337,337,337,337,337,21,
          417,337,337,337,337,337,337,337,337,337,337,419,
          425,15,15,15,15,15,15,15,15,15,15,427,
        ]
        FLOOR2: [
          0,0,0,0,0,0,0,0,0,0,0,0,
          0,0,0,0,0,0,0,0,0,0,0,0,
          0,0,0,0,0,0,0,0,0,0,0,0,
          0,0,0,0,0,0,0,0,0,0,0,0,
          0,0,0,0,0,0,0,0,0,0,0,0,
          0,0,0,0,0,0,0,0,0,0,0,0,
          0,0,0,0,0,0,0,0,0,0,0,0,
          0,0,0,0,0,0,0,0,0,0,0,0,
          0,0,0,0,0,0,0,0,0,0,0,0,
          0,0,0,0,0,0,0,0,0,0,0,0,
          0,0,0,0,0,0,0,0,0,0,0,0,
          0,0,0,0,0,0,0,0,0,0,0,0,
          0,0,0,0,0,0,0,0,0,0,0,0,
          0,0,0,0,0,0,0,0,0,0,0,0,
          0,0,0,0,0,0,0,0,0,0,0,0,
          0,0,0,0,0,0,0,0,0,0,0,0,
          0,0,0,0,0,0,0,0,0,0,0,0,
        ]
        DECORATIONS1: [
          0,0,0,0,0,0,0,0,0,0,0,0,
          0,0,0,0,0,0,0,0,0,0,0,0,
          0,0,0,0,0,0,0,0,0,0,0,0,
          0,0,0,0,0,0,0,0,0,0,0,0,
          0,0,0,0,0,0,0,0,0,0,0,0,
          0,0,0,0,0,0,0,0,0,0,0,0,
          0,0,0,0,0,0,0,0,0,0,0,0,
          0,0,0,0,0,0,0,0,0,0,0,0,
          0,0,0,0,0,0,0,0,0,0,0,0,
          0,0,0,0,0,0,0,0,0,0,0,0,
          0,0,0,0,0,0,0,0,0,0,0,0,
          0,0,0,0,0,0,0,0,0,0,0,0,
          0,0,0,0,0,0,0,0,0,0,0,0,
          0,0,0,0,0,0,0,0,0,0,0,0,
          0,0,0,0,0,0,0,0,0,0,0,0,
          0,0,0,0,0,0,0,0,0,0,0,0,
          0,0,0,0,0,0,0,0,0,0,0,0,
        ]
        DECORATIONS2: [
          0,0,0,0,0,0,0,0,0,0,0,0,
          0,0,0,0,0,0,0,0,0,0,0,0,
          0,0,0,0,0,0,0,0,0,0,0,0,
          0,0,0,0,0,0,0,0,0,0,0,0,
          0,0,0,0,0,0,0,0,0,0,0,0,
          0,0,0,0,0,0,0,0,0,0,0,0,
          0,0,0,0,0,0,0,0,0,0,0,0,
          0,0,0,0,0,0,0,0,0,0,0,0,
          0,0,0,0,0,0,0,0,0,0,0,0,
          0,0,0,0,0,0,0,0,0,0,0,0,
          0,0,0,0,0,0,0,0,0,0,0,0,
          0,0,0,0,0,0,0,0,0,0,0,0,
          0,0,0,0,0,0,0,0,0,0,0,0,
          0,0,0,0,0,0,0,0,0,0,0,0,
          0,0,0,0,0,0,0,0,0,0,0,0,
          0,0,0,0,0,0,0,0,0,0,0,0,
          0,0,0,0,0,0,0,0,0,0,0,0,
        ]
        COLLISION: [
          2041,2041,2041,2041,2041,0,0,2041,2041,2041,2041,2041,
          2041,2041,2041,2041,2041,0,0,2041,2041,2041,2041,2041,
          2041,2041,2041,2041,2041,0,0,2041,2041,2041,2041,2041,
          2041,0,0,0,0,0,0,0,0,0,0,2041,
          2041,0,0,0,0,0,0,0,0,0,0,2041,
          2041,0,0,0,0,0,0,0,0,0,0,2041,
          2041,0,0,0,0,0,0,0,0,0,0,2041,
          2041,0,0,0,0,0,0,0,0,0,0,0,
          2041,0,0,0,0,0,0,0,0,0,0,0,
          2041,0,0,0,0,0,0,0,0,0,0,2041,
          2041,0,0,0,0,0,0,0,0,0,0,2041,
          2041,0,0,0,0,0,0,0,0,0,0,2041,
          2041,0,0,0,0,0,0,0,0,0,0,2041,
          2041,0,0,0,0,0,0,0,0,0,0,2041,
          2041,0,0,0,0,0,0,0,0,0,0,2041,
          2041,0,0,0,0,0,0,0,0,0,0,2041,
          2041,2041,2041,2041,2041,2041,2041,2041,2041,2041,2041,2041,
        ]
      }
    }

    {
      className: game.entity.item.Room
      path: assets/map/datas/rooms/Room3.png
      hover: une salle
      category: ROOMS
      width: 8
      height: 12
      tiles: {
        FLOOR1: [
          9,3,3,3,3,3,3,10,
          13,417,418,418,418,418,419,13,
          13,425,426,426,426,426,427,13,
          13,337,337,337,337,337,337,13,
          337,337,337,337,337,337,337,13,
          337,337,337,337,337,337,337,13,
          13,337,337,337,337,337,337,13,
          13,337,337,337,337,337,337,13,
          13,337,337,337,337,337,337,13,
          21,337,337,337,337,337,337,21,
          417,337,337,337,337,337,337,419,
          425,15,15,15,15,15,15,427,
        ]
        FLOOR2: [
          0,0,0,0,0,0,0,0,
          0,0,0,0,0,0,0,0,
          0,0,0,0,0,0,0,0,
          0,0,0,0,0,0,0,0,
          0,0,0,0,0,0,0,0,
          0,0,0,0,0,0,0,0,
          0,0,0,0,0,0,0,0,
          0,0,0,0,0,0,0,0,
          0,0,0,0,0,0,0,0,
          0,0,0,0,0,0,0,0,
          0,0,0,0,0,0,0,0,
          0,0,0,0,0,0,0,0,
        ]
        DECORATIONS1: [
          0,0,0,0,0,0,0,0,
          0,0,0,0,0,0,0,0,
          0,0,0,0,0,0,0,0,
          0,0,0,0,0,0,0,0,
          0,0,0,0,0,0,0,0,
          0,0,0,0,0,0,0,0,
          0,0,0,0,0,0,0,0,
          0,0,0,0,0,0,0,0,
          0,0,0,0,0,0,0,0,
          0,0,0,0,0,0,0,0,
          0,0,0,0,0,0,0,0,
          0,0,0,0,0,0,0,0,
        ]
        DECORATIONS2: [
          0,0,0,0,0,0,0,0,
          0,0,0,0,0,0,0,0,
          0,0,0,0,0,0,0,0,
          0,0,0,0,0,0,0,0,
          0,0,0,0,0,0,0,0,
          0,0,0,0,0,0,0,0,
          0,0,0,0,0,0,0,0,
          0,0,0,0,0,0,0,0,
          0,0,0,0,0,0,0,0,
          0,0,0,0,0,0,0,0,
          0,0,0,0,0,0,0,0,
          0,0,0,0,0,0,0,0,
        ]
        COLLISION: [
          2041,2041,2041,2041,2041,2041,2041,2041,
          2041,2041,2041,2041,2041,2041,2041,2041,
          2041,2041,2041,2041,2041,2041,2041,2041,
          2041,0,0,0,0,0,0,2041,
          0,0,0,0,0,0,0,2041,
          0,0,0,0,0,0,0,2041,
          2041,0,0,0,0,0,0,2041,
          2041,0,0,0,0,0,0,2041,
          2041,0,0,0,0,0,0,2041,
          2041,0,0,0,0,0,0,2041,
          2041,0,0,0,0,0,0,2041,
          2041,2041,2041,2041,2041,2041,2041,2041,
        ]
      }
    }
  ]
}